
ZZZ 000000
ZZZ 000000
ZZZ 000000
ZZZ 000000
ZZZ 000000
ZZZ 000000
ZZZ 000000
ZZZ 000000
ZZZ 010175
ZZZ 000000
ZYZ 011962
ZZZ 000000
ZZZ 000000
ZZZ 000000
ZZZ 010112
JBP 009487
ZCA 009450
ZZZ 000000
ZAA 010662
